111111111111111111111111111111
1P000C0000000000000000C0000001
10000C0000000000000000C0000E01
111111111111111111111111111111